SSSSSSSSSSSSSSSS
SSSESSSSESSESSSS
SSSSSSSSBSESSTTT
TTTTTSSSSSSSSTSS
SSSSTSSESSSSSTSS
SSSSTSSSSSSSSTSS
SSSSTSSSSESSSTSS
SSESTTTTTTTTTTSS
SSSSSSSSSSSSSSSS